10,10,10,10,10,10,10,10,10,10,10,10,10,10,10,10
5,5,5,10,10,10,10,10,10,10,10,10,5,5,2,10
5,5,5,10,10,10,10,10,10,10,10,10,5,5,4,10
6,1,6,6,6,6,6,6,6,6,6,6,6,6,4,10
6,6,1,6,1,6,1,1,6,6,6,6,1,1,4,10
1,1,6,6,6,6,6,6,6,6,6,6,6,6,4,10
5,5,5,10,10,10,10,10,10,10,10,10,5,5,4,10
5,5,5,10,10,10,10,10,10,10,10,10,5,5,3,10
10,10,10,10,10,10,10,10,10,10,10,10,10,10,10,10
